00000000000
01111011110
01001010010
01001010010
01111111110
00010001000
01111111110
01001010010
01001010010
01111011110
00000000000